11111111111111111111111111111111111111111111111111
10000000000000000000000000000000000000000000000001
10000000000000000000000000000000000000000000000001
10000000000000000000000000000000000000000000000001
10000000000000000000000000000000000000000000000001
10000000000000000000000000000000000000000000000001
10000000000000000000000000000000000000000000000001
10000000000000000000000000000000000000000000000001
10000000000000000000000000000000000000000000000001
10000000000000000000000000000000000000000000000001
10000000000000000000000000000000000000000000000001
10000000001100000000000000000000000000000000000001
10000000000000000000000000000000000000000000000001
10000000000000000000000000000000000000000000000001
11111111111111111111111111111111111111111111111111
11111100000000000000111111111111111111000000000111
11111000000000200000011111111111111110000200000011
11110000000000000000001111111111111110000000000011
11100003000111111000300111111111111110301111030111
11000000001111111100000001111111111110001111000011
11000300011111111110003000111111111110301111000011
11000000111111111111000000011111111000001111000011
11003001111111111111100030001111110000011111000011
11000011111111111111110000002002020000111111103011
11030111111111111111110000000000000000111111100001
11000111111111111111111111111111111111111111103001
11000000000000000000000000000000000000000000000001
11000400202020020020002000200020002000200020200001
11000000000000000000000000000000000000000000000001
11111111111111111111111111111111111111111111111111